111111111111111
1PCCCCCCCCCCCE1
110111000001111
100000000001111
111111111111111