11111111111111111111111111111111111111111
1PCCCCCCCCCCCCCCC011111111111111111111111
11111111111111111011111111111111111111111
11111111111111111010CCCCC010CCCCCCCCCCCC1
11111111111111111000111110101111111111111
1CCCCCCCCCC011111011111111101111111111111
111111111110111110CCCCCCCCC0CCCCCCCCCCCC1
11111111111011111011111111101111111111111
11111111111011111011111111101111111111111
1CCCC011111011111010CCCCC010CCCCCCCCCCCC1
11111011111011111000111110101111111111111
11111011111011111011111111101111111111111
11111011111011111011111111101111111111111
1C0CC0CC0CC0CC0CC0CCCCCCCCC0CCCCCCCCCCCE1
11011111C11111011111111111101111011111111
1CC11111011111011111111111101111011111111
111111110111110111111111111011110CCCCCCC1
11111111011111011111111111101111011111111
11111111011111011111111111101111011111111
1CCCCCCC0111110111111111111011110CCCCCCC1
11111111111111011111111111101111011111111
11111111111111011111111111101111011111111
11111111111111011111111111101111011111111
1CCCCCCCCCCCCCC1111111111110CCCC0CCCCCCC1
11111111111111111111111111111111111111111
11111111111111111111111111111111111111111
11111111111111111111111111111111111111111